########################################
#........................###############
#....G........................##########
#...................................####
#################......................#
#................###########...........#
#.................##########...........#
#..........##......#########...........#
#.........####.......#######...........#
#........######........................#
#.......########.......................#
#......##########......................#
#..S..############...####..............#
#....##############.####...............#
#...#######################............#
#...#######################............#
########################################
