########################################
#......................................#
#......................................#
#......................................#
#........#########################.....#
#.......##########################.....#
#......#########################.......#
#.....########################.........#
#....#######################...........#
#....#####################.............#
#....###################...............#
#.S..##################................#
#....################..................#
#....###############....G..............#
#....#############.....................#
#.....##########.......................#
########################################
