######################################
#....................................#
#....................................#
#....................................#
#....................................#
#............#######.................#
#...........#########................#
#..........###########...............#
#..........###########...............#
#.........#############..............#
#.........#############..............#
#...S....###############.............#
#........###############............G#
#.......#################............#
#......###################...........#
#.....#####################..........#
######################################
