############################
#S.........................#
#..........................#
#..........................#
#..........................#
#..........................#
#..........................#
#..........................#
#..........................#
#..........................#
#..........................#
#..........................#
#..........................#
#..........................#
#..........................#
#..........................#
#.........................G#
############################
